Audios:	Translation	Gender:
/content/drive/MyDrive/dataset/clips/1.wav	مجھے یہ سبجیکٹ بہت پسند ہے	Male
/content/drive/MyDrive/dataset/clips/2.wav	بینکرزلوگوں کا پیسہ محفوظ رکھتے ہیں	Male
/content/drive/MyDrive/dataset/clips/3.wav	یہ لواس میں تمہاری چیک بک ہے	Male
/content/drive/MyDrive/dataset/clips/4.wav	یہ سارا اہتمام شادی کے لئے ہے	Male
/content/drive/MyDrive/dataset/clips/5.wav	اگر یہ دنیا میری ہوتی تو میں تمہیں دے دیتا	Male
/content/drive/MyDrive/dataset/clips/6.wav	اتنی زیادہ رقم ملے گی	Male
/content/drive/MyDrive/dataset/clips/7.wav	یہ میری سیونگز ہیں	Male
/content/drive/MyDrive/dataset/clips/8.wav	أمامہ ہم کل کراچی جا رہے ہیں	Male
/content/drive/MyDrive/dataset/clips/9.wav	تمہیں ساتھ لے کر آنے سے مجھے اچھا لگ رہا ہے	Male
/content/drive/MyDrive/dataset/clips/10.wav	میں نے سوچا کے ہوٹل میں ٹھہرے گے 	Male
/content/drive/MyDrive/dataset/clips/11.wav	وہ بہت خوش ہے اس لئے میں بھی خوش ہوں	Male
/content/drive/MyDrive/dataset/clips/12.wav	بوندا باری ہو رہی ہے	Male
/content/drive/MyDrive/dataset/clips/13.wav	اس کو مجھ سے ہمدردی ہے	Male
/content/drive/MyDrive/dataset/clips/14.wav	میں ہماری گفتگو سے لطف اندوز ہوا	Male
/content/drive/MyDrive/dataset/clips/15.wav	یار میرا کام تو بن گیا ہے 	Male
/content/drive/MyDrive/dataset/clips/16.wav	آپ کے ساتھ ہونا ہی میری پسندیدہ جگہ ہے 	Male
/content/drive/MyDrive/dataset/clips/17.wav	مجھے ہمیشہ سے اس کو دیکھ کر فرحت ہوئی ہے	Male
/content/drive/MyDrive/dataset/clips/18.wav	مجھے خوشی ہے کہ وہ بھی یہاں ہوں گے	Male
/content/drive/MyDrive/dataset/clips/19.wav	پھول بھی خوشی دیتے ہیں	Male
/content/drive/MyDrive/dataset/clips/20.wav	مبارک ہو ہم میچ جیت گئے	Male
/content/drive/MyDrive/dataset/clips/21.wav	اتنے عرصے بعد تمہیں دیکھ کر خوشی ہوئی	Female
/content/drive/MyDrive/dataset/clips/22.wav	یہ میری زندگی کا سب سے خوبصورت دن ہے	Female
/content/drive/MyDrive/dataset/clips/23.wav	بارش مجھے بہت پسند ہے 	Female
/content/drive/MyDrive/dataset/clips/24.wav	خوبصورت گفٹ کے لیے شکریہ	Female
/content/drive/MyDrive/dataset/clips/25.wav	میں کچھ دنوں تک بالکل ٹھیک ہو جاؤگی	Female
/content/drive/MyDrive/dataset/clips/26.wav	آپ کو شادی کی بہت بہت مبارک ہو 	Female
/content/drive/MyDrive/dataset/clips/27.wav	مجھے آپ کی کامیابی دیکھ کر بہت خوشی ملی	Female
/content/drive/MyDrive/dataset/clips/28.wav	میں خالہ کے گھر جانے کی تیاری کر رہی ہوں	Female
/content/drive/MyDrive/dataset/clips/29.wav	آپ سے مل کر پریشانی دور ہو گئی	Female
/content/drive/MyDrive/dataset/clips/30.wav	اس کے پاس پیسے نہیں تھے اس لیے میں نےبل دے دیا 	Female
/content/drive/MyDrive/dataset/clips/31.wav	تم نے کیا جادو کیا ہوا ہے مجھ پہ	Male
/content/drive/MyDrive/dataset/clips/32.wav	وہ میرے ساتھ خوش ہے اور میں اس کے ساتھ خوش ہوں 	Male
/content/drive/MyDrive/dataset/clips/33.wav	مجھے سب کھانے پسند ہیں	Male
/content/drive/MyDrive/dataset/clips/34.wav	ٹھیک ہے مجھے سن کر خوشی ہوئی	Male
/content/drive/MyDrive/dataset/clips/35.wav	میں بھی ساتھ جانے کے لئے تیار ہوں	Male
/content/drive/MyDrive/dataset/clips/36.wav	تو تم یہ قربانی دینے کے لیے تیار ہواچھا ہے	Male
/content/drive/MyDrive/dataset/clips/37.wav	وہاں ویسے بھی تعلیم کے لئے وقت کم لگے گا تو میں وہاں ہی جاؤں گا	Male
/content/drive/MyDrive/dataset/clips/38.wav	اس کے گانےبہت اچھے ہیں	Male
/content/drive/MyDrive/dataset/clips/39.wav	میں بھی شکر ادا کروں گا کہ وہاں جاؤں	Male
/content/drive/MyDrive/dataset/clips/40.wav	مجھے بھی اچھا خواب آیا تھا	Male
/content/drive/MyDrive/dataset/clips/41.wav	میرا چہرہ خوشی سے لال ہے 	Female
/content/drive/MyDrive/dataset/clips/42.wav	میں اپنی زندگی کے لیے شکر گزار ہوں	Female
/content/drive/MyDrive/dataset/clips/43.wav	آج کا دن بہت خوش نما ہے	Female
/content/drive/MyDrive/dataset/clips/44.wav	زندگی اچھی ہے اور میں خوش ہوں 	Female
/content/drive/MyDrive/dataset/clips/45.wav	اچھا وقت زندگی خوبصورت بنا تاہے	Female
/content/drive/MyDrive/dataset/clips/46.wav	میرا دل خوشی سے بھر گیا 	Female
/content/drive/MyDrive/dataset/clips/47.wav	تمہیں دیکھ کر بہت اچھا لگا	Female
/content/drive/MyDrive/dataset/clips/48.wav	میں خوشی سے جھوم رہا ہوں	Female
/content/drive/MyDrive/dataset/clips/49.wav	ہر دن خوشی کا دن ہے اور میں اس خوشی سے بھر رہا ہوں	Female
/content/drive/MyDrive/dataset/clips/50.wav	میں آج بادلوں میں سفر کر رہا ہوں	Female
/content/drive/MyDrive/dataset/clips/51.wav	 میں آج بہت خوش ہوں 	Male
/content/drive/MyDrive/dataset/clips/52.wav	مجھے تم سے بات کر کے بہت اچھا لگتا ہے 	Male
/content/drive/MyDrive/dataset/clips/53.wav	تم میرے لیے خاص ہو 	Male
/content/drive/MyDrive/dataset/clips/54.wav	خوشی سے میرا دل باغ باغ ہو گیا 	Male
/content/drive/MyDrive/dataset/clips/55.wav	کامیابی آپ کے قدم چومے 	Male
/content/drive/MyDrive/dataset/clips/56.wav	 نیا سال بہت مبارک ہو 	Male
/content/drive/MyDrive/dataset/clips/57.wav	آپ کی دعوت کا شکریہ 	Male
/content/drive/MyDrive/dataset/clips/58.wav	اللہ آپ کو چاند سا بیٹا دے 	Male
/content/drive/MyDrive/dataset/clips/59.wav	مجھے امید ہے ہم جیت جائیں گے	Male
/content/drive/MyDrive/dataset/clips/60.wav	 میں آزاد ملک میں پیدا ہونے پر اچھا محسوس کرتا ہوں 	Male
/content/drive/MyDrive/dataset/clips/61.wav	آج کیا ہی اچھا موسم ہے 	Female
/content/drive/MyDrive/dataset/clips/62.wav	میرا بھائی ڈاکٹر بن گیا	Female
/content/drive/MyDrive/dataset/clips/63.wav	 آج ہمیں چھٹی ہے 	Female
/content/drive/MyDrive/dataset/clips/64.wav	میں اس تعفی پر بہت شکر گزار ہوں 	Female
/content/drive/MyDrive/dataset/clips/65.wav	اللہ کرے یہ دن بار بار آئے 	Female
/content/drive/MyDrive/dataset/clips/66.wav	پیپرز کے بعد مکمل سکون ملتا ہے	Female
/content/drive/MyDrive/dataset/clips/67.wav	 آج میں بہت اچھی لگ رہی ہو	Female
/content/drive/MyDrive/dataset/clips/68.wav	 خوش رہیں 	Female
/content/drive/MyDrive/dataset/clips/69.wav	قسمت بھی آپ کا ساتھ دے رہی ہے	Female
/content/drive/MyDrive/dataset/clips/70.wav	 یہ میری باعث مسرت ہے 	Female
/content/drive/MyDrive/dataset/clips/71.wav	میرے پاس کافی پیسہ	Male
/content/drive/MyDrive/dataset/clips/72.wav	 ہے دوبارہ ملاقات ہوگی 	Male
/content/drive/MyDrive/dataset/clips/73.wav	یار میرا کام تو ہو گیا ہے	Male
/content/drive/MyDrive/dataset/clips/74.wav	 دل کو دل سے راہ ہوتی ہے	Male
/content/drive/MyDrive/dataset/clips/75.wav	 آپ نے مجھے عزت بخشی 	Male
/content/drive/MyDrive/dataset/clips/76.wav	آپ کی آنکھیں بہت پیاری ہیں 	Male
/content/drive/MyDrive/dataset/clips/77.wav	آپ کی تعریف کرنے کے لئےمیرے پاس الفاظ نہیں ہے 	Male
/content/drive/MyDrive/dataset/clips/78.wav	تم کھلے دل کے مالک ہو 	Male
/content/drive/MyDrive/dataset/clips/79.wav	تم سب کے دلوں پر راج کرتے ہو 	Male
/content/drive/MyDrive/dataset/clips/80.wav	الماری سجانی ہے	Male
/content/drive/MyDrive/dataset/clips/81.wav	 میں بہت خوش ہوں 	Female
/content/drive/MyDrive/dataset/clips/82.wav	مجھے خوشی ہو رہی ہے 	Female
/content/drive/MyDrive/dataset/clips/83.wav	میں بہت خوش قسمت ہوں 	Female
/content/drive/MyDrive/dataset/clips/84.wav	میں بہت مطمئن ہوں 	Female
/content/drive/MyDrive/dataset/clips/85.wav	میری یہ خوشی اب تک کی سب سے بڑی خوشی ہے 	Female
/content/drive/MyDrive/dataset/clips/86.wav	مجھے اپنی دوست بہت پسند ہیں	Female
/content/drive/MyDrive/dataset/clips/87.wav	 مجھے اپنا گاؤں بہت اچھا لگتا ہے 	Female
/content/drive/MyDrive/dataset/clips/88.wav	میں اپنے نئے کمرے میں بہت خوش ہوں 	Female
/content/drive/MyDrive/dataset/clips/89.wav	میں اپنے سفر کی خوشی میں اداس نہیں ہوں 	Female
/content/drive/MyDrive/dataset/clips/90.wav	یہ میری سب سے بڑی جیت ہے 	Female
/content/drive/MyDrive/dataset/clips/91.wav	امی بہت خوش ہے 	Female
/content/drive/MyDrive/dataset/clips/92.wav	میں تمہاری جیت میں خوش ہوں 	Female
/content/drive/MyDrive/dataset/clips/93.wav	کتنی پیاری خوشبو آ رہی ہے 	Female
/content/drive/MyDrive/dataset/clips/94.wav	میری خوش نصیبی ہے کہ آپ کا ساتھ ملا	Female
/content/drive/MyDrive/dataset/clips/95.wav	 کیا تم میرے ساتھ چلو گی	Female
/content/drive/MyDrive/dataset/clips/96.wav	 ہم مری جا رہے ہیں	Female
/content/drive/MyDrive/dataset/clips/97.wav	 مجھے بریانی پسند ہے	Female
/content/drive/MyDrive/dataset/clips/98.wav	 میری بہن کا بیٹا پیدا ہوا ہے 	Female
/content/drive/MyDrive/dataset/clips/99.wav	ممبر وہ مسکرایا ہے مجھے دیکھ کے 	Female
/content/drive/MyDrive/dataset/clips/100.wav	میں خوشی محسوس کر سکتا ہوں  	Female
/content/drive/MyDrive/dataset/clips/101.wav	لیکن وہ آپ کو پسند نہیں کرتے	Male
/content/drive/MyDrive/dataset/clips/102.wav	رات ہوگئی ہے اب جانا چاہیے 	Male
/content/drive/MyDrive/dataset/clips/103.wav	وہ آپ پر بھروسہ نہیں کرتے 	Male
/content/drive/MyDrive/dataset/clips/104.wav	نہیں میں پارٹیز میں نہیں جاتا 	Male
/content/drive/MyDrive/dataset/clips/105.wav	کیا تمہیں میرے ساتھ آ کر اچھا نہیں لگا	Male
/content/drive/MyDrive/dataset/clips/106.wav	وہ یہاں آخری بار آئے گا	Male
/content/drive/MyDrive/dataset/clips/107.wav	تمہارا رویہ اچھا نہیں تھا 	Male
/content/drive/MyDrive/dataset/clips/108.wav	وہ مجھے ڈانٹ رہی تھی	Male
/content/drive/MyDrive/dataset/clips/109.wav	ابو مجھے ذلیل کریں گے اور تمہیں کچھ نہیں کہیں گے	Male
/content/drive/MyDrive/dataset/clips/110.wav	ہم نہیں جائیں گے یہ نہ ہو تم کوئی اور مصیبت کھڑی کردو	Male
/content/drive/MyDrive/dataset/clips/111.wav	وہ نہیں جیتا اس لیے پریشان تھا 	Male
/content/drive/MyDrive/dataset/clips/112.wav	لیڈی ڈیانامر گئی ہے ہے	Male
/content/drive/MyDrive/dataset/clips/113.wav	اللہ حافظ کہنا واقعی مشکل ہے 	Male
/content/drive/MyDrive/dataset/clips/114.wav	مجھے اس بات سے بہت رونا آیا 	Male
/content/drive/MyDrive/dataset/clips/115.wav	تم تو ایسا نہیں کرنا چاہتے تھے 	Male
/content/drive/MyDrive/dataset/clips/116.wav	صبح اٹھنے سے میں اچھا محسوس نہیں کرتی 	Male
/content/drive/MyDrive/dataset/clips/117.wav	اب امتحان ہیں اسلئے میں پریشان ہوں 	Male
/content/drive/MyDrive/dataset/clips/118.wav	سچ بتاؤ ں تو سن کر اچھا نہیں لگا 	Male
/content/drive/MyDrive/dataset/clips/119.wav	ایسا کرنے سے کچھ حاصل نہیں ہوگا 	Male
/content/drive/MyDrive/dataset/clips/120.wav	تم واقعی اذیت میں ہو	Male
/content/drive/MyDrive/dataset/clips/121.wav	لگتا ہےوہاں حادثہ ہوا ہے 	Female
/content/drive/MyDrive/dataset/clips/122.wav	یہ تو بہت دور ہے 	Female
/content/drive/MyDrive/dataset/clips/123.wav	امی  کتنے دنوں سے بیمار ہیں	Female
/content/drive/MyDrive/dataset/clips/124.wav	اور وہ دل سے اتر گیا	Female
/content/drive/MyDrive/dataset/clips/125.wav	سب تمہارے جیسے نہیں ہیں	Female
/content/drive/MyDrive/dataset/clips/126.wav	میں بہت اداس ہوں 	Female
/content/drive/MyDrive/dataset/clips/127.wav	بھائی نے امی سے بدتمیزی کی ہے 	Female
/content/drive/MyDrive/dataset/clips/128.wav	دوبارہ ملاقات نہیں ہو گی	Female
/content/drive/MyDrive/dataset/clips/129.wav	مجھے گفتگو میں کچھ باتیں اچھی نہیں لگی	Female
/content/drive/MyDrive/dataset/clips/130.wav	مجھے اکثر سردی ہو جاتی ہے	Female
/content/drive/MyDrive/dataset/clips/131.wav	میری کوئی عزت نہیں کرتا 	Male
/content/drive/MyDrive/dataset/clips/132.wav	کسی نے کچھ نہیں کہا لیکن میں پھربھی اداس ہوں	Male
/content/drive/MyDrive/dataset/clips/133.wav	میں کل رات سے خوار ہو رہا ہوں	Male
/content/drive/MyDrive/dataset/clips/134.wav	مجھے بہت افسوس ہے	Male
/content/drive/MyDrive/dataset/clips/135.wav	تمہیں اس کو سپورٹ نہیں کرنا چاہیے تھا 	Male
/content/drive/MyDrive/dataset/clips/136.wav	میں اس حال میں تمہیں یہاں نہیں چھوڑ سکتا 	Male
/content/drive/MyDrive/dataset/clips/137.wav	ہم انہیں پاس نہیں رکھ سکتے	Male
/content/drive/MyDrive/dataset/clips/138.wav	تم نے تو کہا تھا ایسے مسائل نہیں ہوں گے 	Male
/content/drive/MyDrive/dataset/clips/139.wav	میرے لئے تمہارے بغیر رہنا بہت مشکل ہے	Male
/content/drive/MyDrive/dataset/clips/140.wav	مجھے بہت فکر ہے اپنے گھر والوں کی	Male
/content/drive/MyDrive/dataset/clips/141.wav	میری زندگی میں کچھ کمی ہے 	Female
/content/drive/MyDrive/dataset/clips/142.wav	میری آواز اداس ہے اور میرا چہرہ  زرد ہے 	Female
/content/drive/MyDrive/dataset/clips/143.wav	میں دکھی ہوں اور کسی سے بات نہیں کرنا چاہتا	Female
/content/drive/MyDrive/dataset/clips/144.wav	میں تنہا محسوس کر رہا ہوں 	Female
/content/drive/MyDrive/dataset/clips/145.wav	میری زندگی میں روشنی نہیں ہے 	Female
/content/drive/MyDrive/dataset/clips/146.wav	میں خود سے الگ اور دور ہو گیا ہوں 	Female
/content/drive/MyDrive/dataset/clips/147.wav	میں اندھیروں میں گھرا ہوا ہوں 	Female
/content/drive/MyDrive/dataset/clips/148.wav	میں کسی سے بات نہیں کرنا چاہتا	Female
/content/drive/MyDrive/dataset/clips/149.wav	دل کی امید توڑ دی ہے کسی نے 	Female
/content/drive/MyDrive/dataset/clips/150.wav	خود سےنفرت ہونے لگی ہے	Female
/content/drive/MyDrive/dataset/clips/151.wav	 ماں کے جانے کے بعد یہ بچہ رو رہا تھا	Male
/content/drive/MyDrive/dataset/clips/152.wav	 مجھے ابھی ایک افسوسناک خبر موصول ہوئی	Male
/content/drive/MyDrive/dataset/clips/153.wav	 تم میرے ساتھ ایسا کیسے کر سکتے ہو	Male
/content/drive/MyDrive/dataset/clips/154.wav	 میں بہت دکھی ہوں 	Male
/content/drive/MyDrive/dataset/clips/155.wav	میری قسمت بری ہے 	Male
/content/drive/MyDrive/dataset/clips/156.wav	آپ میرے یقین کیوں نہیں کرتے میں	Male
/content/drive/MyDrive/dataset/clips/157.wav	 اپنی جاب کو لے کر پریشان ہو 	Male
/content/drive/MyDrive/dataset/clips/158.wav	اس نے مجھے دھوکا دیا 	Male
/content/drive/MyDrive/dataset/clips/159.wav	میرا پرس کھو گیا ہے 	Male
/content/drive/MyDrive/dataset/clips/160.wav	وہ میرا برتھ ڈے تک بھول گیا	Male
/content/drive/MyDrive/dataset/clips/161.wav	 میں سن رہا ہوں 	Female
/content/drive/MyDrive/dataset/clips/162.wav	پچھتاؤ گے تم	Female
/content/drive/MyDrive/dataset/clips/163.wav	میں شرمندہ ہوں 	Female
/content/drive/MyDrive/dataset/clips/164.wav	وقت ضائع مت کریں 	Female
/content/drive/MyDrive/dataset/clips/165.wav	میرا گلا خراب ہے 	Female
/content/drive/MyDrive/dataset/clips/166.wav	آجکل نوکری ملنا بہت مشکل ہے 	Female
/content/drive/MyDrive/dataset/clips/167.wav	وہ مجھ سے دور چلی گئی ہے	Female
/content/drive/MyDrive/dataset/clips/168.wav	 میرے بہت کم نمبر آئے 	Female
/content/drive/MyDrive/dataset/clips/169.wav	میں نے آج رات کا کھانا نہیں کھایا 	Female
/content/drive/MyDrive/dataset/clips/170.wav	میں سب پر بوجھ ہوں 	Female
/content/drive/MyDrive/dataset/clips/171.wav	اسے دیکھ کر مجھے اپنے بھائی کی یاد آگئی	Male
/content/drive/MyDrive/dataset/clips/172.wav	 اس پر صد افسوس	Male
/content/drive/MyDrive/dataset/clips/173.wav	 اس کے ہاتھوں کی لوگوں نے دکھ اٹھایا	Male
/content/drive/MyDrive/dataset/clips/174.wav	 کیا دشمنی ہے تم کو مجھ سے	Male
/content/drive/MyDrive/dataset/clips/175.wav	 مجھے کیا صلہ ملا 	Male
/content/drive/MyDrive/dataset/clips/176.wav	اس کی مجھ سے بات چیت نہیں ہے	Male
/content/drive/MyDrive/dataset/clips/177.wav	 اچھائی کا زمانہ ہی نہیں ہے 	Male
/content/drive/MyDrive/dataset/clips/178.wav	اس وقت ہر کوئی خود غرض ہے 	Male
/content/drive/MyDrive/dataset/clips/179.wav	تم اس کے خلاف کیوں ہو 	Male
/content/drive/MyDrive/dataset/clips/180.wav	اس نے میرا وقت برباد کیا	Male
/content/drive/MyDrive/dataset/clips/181.wav	 مجھے دکھ ہو رہا ہے 	Female
/content/drive/MyDrive/dataset/clips/182.wav	مجھے یہ امید نہیں تھی کہ میں فیل ہو جاؤں گا	Female
/content/drive/MyDrive/dataset/clips/183.wav	 میرے سارے رشتہ دار گاؤں میں ہیں 	Female
/content/drive/MyDrive/dataset/clips/184.wav	میرا خواب تھا اس گاڑی کو حاصل کرنا 	Female
/content/drive/MyDrive/dataset/clips/185.wav	میں اپنے حالات سے بہت ناراض ہوں	Female
/content/drive/MyDrive/dataset/clips/186.wav	 میں اندر سے بہت ٹوٹ چکا ہوں 	Female
/content/drive/MyDrive/dataset/clips/187.wav	میرا نصیب بہت برا ہے 	Female
/content/drive/MyDrive/dataset/clips/188.wav	اتنا خاص موقع برباد ہو گیا	Female
/content/drive/MyDrive/dataset/clips/189.wav	 ہماری دوستی کا اختتام ہوا 	Female
/content/drive/MyDrive/dataset/clips/190.wav	میں نے ایسا تو نہ چاہا تھا 	Female
/content/drive/MyDrive/dataset/clips/191.wav	میری زندگی میں کوئی خوشی نہیں ہے	Female
/content/drive/MyDrive/dataset/clips/192.wav	 میری آنکھوں میں آنسو آگئے 	Female
/content/drive/MyDrive/dataset/clips/193.wav	میں بے بس ہوں 	Female
/content/drive/MyDrive/dataset/clips/194.wav	تم نے میرا دل دکھایا	Female
/content/drive/MyDrive/dataset/clips/195.wav	 میں تنہا ہوں 	Female
/content/drive/MyDrive/dataset/clips/196.wav	میری آنکھیں نم ہے 	Female
/content/drive/MyDrive/dataset/clips/197.wav	ساری مصیبت ہمیشہ مجھ پر ہی کیوں آتی ہے 	Female
/content/drive/MyDrive/dataset/clips/198.wav	میری زندگی میں کوئی رونق نہیں ہے 	Female
/content/drive/MyDrive/dataset/clips/199.wav	اس خوشی کے موقع پر کاش وہ میرے ساتھ ہوتا 	Female
/content/drive/MyDrive/dataset/clips/200.wav	ان سب نے مجھے اکیلا چھوڑ دیا ہے	Female
/content/drive/MyDrive/dataset/clips/201.wav	تمہیں اسے یہاں نہیں لانا چاہیے تھا	Male
/content/drive/MyDrive/dataset/clips/202.wav	ایک بار بات سمجھ کیوں نہیں آتی تمہیں 	Male
/content/drive/MyDrive/dataset/clips/203.wav	اس کے بعد اکیلے آنے کی ضرورت نہیں ہے	Male
/content/drive/MyDrive/dataset/clips/204.wav	گاڑی آرام سے چلاؤ	Male
/content/drive/MyDrive/dataset/clips/205.wav	اب اتنی وفاداری دکھانے کی ضرورت نہیں ہے 	Male
/content/drive/MyDrive/dataset/clips/206.wav	تمہاری وجہ سے ابو ناراض ہوگئے 	Male
/content/drive/MyDrive/dataset/clips/207.wav	میں اسلام آباد میں نہیں رہ سکتی	Male
/content/drive/MyDrive/dataset/clips/208.wav	بعض دفع ہو سکتا ہے سالوں میں بھی نہ آؤں 	Male
/content/drive/MyDrive/dataset/clips/209.wav	مجھے تمہاری کافی کی ضرورت نہیں ہے	Male
/content/drive/MyDrive/dataset/clips/210.wav	وہ وہاں اکیلے نہیں ہیں تم اپنا کام کرو 	Male
/content/drive/MyDrive/dataset/clips/211.wav	مجھے بہت الجھن ہوتی ہے اس کے ساتھ نہیں رہ سکتا 	Male
/content/drive/MyDrive/dataset/clips/212.wav	مجھے کوئی بات نہیں کرنی	Male
/content/drive/MyDrive/dataset/clips/213.wav	یہ تمہارا مسئلہ نہیں ہے 	Male
/content/drive/MyDrive/dataset/clips/214.wav	اپنے کام سے کام رکھو	Male
/content/drive/MyDrive/dataset/clips/215.wav	تم ذرا صبر کرو 	Male
/content/drive/MyDrive/dataset/clips/216.wav	اس کی ہمت کیسے ہوئی	Male
/content/drive/MyDrive/dataset/clips/217.wav	میں تنگ آگیا ہوں 	Male
/content/drive/MyDrive/dataset/clips/218.wav	میں واقعی کسی کی مدد نہیں چاہتا 	Male
/content/drive/MyDrive/dataset/clips/219.wav	مجھے بتانے کی ضرورت نہیں ہے	Male
/content/drive/MyDrive/dataset/clips/220.wav	میں تمہاری ہڈیاں یا توڑ دوں گا	Male
/content/drive/MyDrive/dataset/clips/221.wav	میری نقل مت اتارو	Female
/content/drive/MyDrive/dataset/clips/222.wav	تم ان سب جیسے ہی ہو	Female
/content/drive/MyDrive/dataset/clips/223.wav	مجھے یہ باتیں سننے میں دلچسپی نہیں ہے 	Female
/content/drive/MyDrive/dataset/clips/224.wav	مجھے انتظار سے نفرت ہے 	Female
/content/drive/MyDrive/dataset/clips/225.wav	تم ہمیشہ جھوٹ بولتے ہو 	Female
/content/drive/MyDrive/dataset/clips/226.wav	تمہاری ہمت کیسے ہوئی یہ سب کہنے کی 	Female
/content/drive/MyDrive/dataset/clips/227.wav	جاؤ اور پکا پکایا کھانا لاؤ	Female
/content/drive/MyDrive/dataset/clips/228.wav	کمرہ  ہرحال میں صاف ہونا چاہیے	Female
/content/drive/MyDrive/dataset/clips/229.wav	وجہ کوئی بھی ہوتم نے غلط کیا 	Female
/content/drive/MyDrive/dataset/clips/230.wav	کارکا لاک کیوں نہیں بند کیا تھا	Female
/content/drive/MyDrive/dataset/clips/231.wav	تم مجھے غصہ دلا رہی ہو	Male
/content/drive/MyDrive/dataset/clips/232.wav	میں ناراض ہوں تم سے 	Male
/content/drive/MyDrive/dataset/clips/233.wav	تمہاری باتوں سے مجھے تکلیف ہو رہی ہے 	Male
/content/drive/MyDrive/dataset/clips/234.wav	میں تمہارے بارے میں برا نہیں سوچ رہا چلی جاؤ	Male
/content/drive/MyDrive/dataset/clips/235.wav	تمہاری حرکتوں پہ مجھے غصہ آ رہا ہے 	Male
/content/drive/MyDrive/dataset/clips/236.wav	 اپنی حد میں رہو تو بہتر ہوگا 	Male
/content/drive/MyDrive/dataset/clips/237.wav	دل کررہا ہے تمہیں تھپڑ مار دو ں	Male
/content/drive/MyDrive/dataset/clips/238.wav	میں بہت غصے میں ہوں	Male
/content/drive/MyDrive/dataset/clips/239.wav	غصے سے سر پھٹ رہا ہے 	Male
/content/drive/MyDrive/dataset/clips/240.wav	تم میرا صبر نہ آزماؤ	Male
/content/drive/MyDrive/dataset/clips/241.wav	تمہیں ادھر ہی رہنا چاہیے گھر پر 	Female
/content/drive/MyDrive/dataset/clips/242.wav	اس بات کا ایشو بنانے کی ضرورت نہیں ہے	Female
/content/drive/MyDrive/dataset/clips/243.wav	تو کیا تم یہ گھر نہیں چھوڑو گے	Female
/content/drive/MyDrive/dataset/clips/244.wav	ایسا کرنے کی ہمت بھی نہ کرنا	Female
/content/drive/MyDrive/dataset/clips/245.wav	مجھے جذباتی طور پر بلیک میل کرنے کی ضرورت نہیں ہے	Female
/content/drive/MyDrive/dataset/clips/246.wav	میں کیسے روز ملوں گا	Female
/content/drive/MyDrive/dataset/clips/247.wav	تمہیں میری بات کی سمجھ کیوں نہیں آتی	Female
/content/drive/MyDrive/dataset/clips/248.wav	تمہیں میں بعد میں دیکھتا ہوں 	Female
/content/drive/MyDrive/dataset/clips/249.wav	میں خود غرض نہیں ہوں	Female
/content/drive/MyDrive/dataset/clips/250.wav	ایسی باتیں کرنا بند کرو تم	Female
/content/drive/MyDrive/dataset/clips/251.wav	 اپنی اوقات میں رہو 	Male
/content/drive/MyDrive/dataset/clips/252.wav	میں تم سے ناراض ہوں 	Male
/content/drive/MyDrive/dataset/clips/253.wav	میں اس روٹین سے تنگ آگیا ہوں 	Male
/content/drive/MyDrive/dataset/clips/254.wav	میں تمہیں چھوڑوں گا نہیں	Male
/content/drive/MyDrive/dataset/clips/255.wav	 اپنی زبان کو لگام دو 	Male
/content/drive/MyDrive/dataset/clips/256.wav	میں آپ سے ڈرتا نہیں ہوں 	Male
/content/drive/MyDrive/dataset/clips/257.wav	میں تمہارے منہ پر تھپڑ مار دوں گا	Male
/content/drive/MyDrive/dataset/clips/258.wav	 خاموشی سے بیٹھے نے تو یہاں سے دفع ہو جاؤ 	Male
/content/drive/MyDrive/dataset/clips/259.wav	ہمت ہے تو ایسا کرکے دکھاؤ 	Male
/content/drive/MyDrive/dataset/clips/260.wav	وہ اپنے سٹوڈنٹس کے ساتھ شدید غصہ تھا 	Male
/content/drive/MyDrive/dataset/clips/261.wav	سب تمہارے جیسے نہیں ہیں	Female
/content/drive/MyDrive/dataset/clips/262.wav	 میری نقل مت اتارو	Female
/content/drive/MyDrive/dataset/clips/263.wav	 کرنے دو جو وہ کرتا ہے 	Female
/content/drive/MyDrive/dataset/clips/264.wav	میں تمہارا لحاظ کر رہا ہوں	Female
/content/drive/MyDrive/dataset/clips/265.wav	 تم مجھ سے بچ کر رہو	Female
/content/drive/MyDrive/dataset/clips/266.wav	 اپنی حد میں رہو 	Female
/content/drive/MyDrive/dataset/clips/267.wav	تمہیں کام کرتے وقت موت پڑتی ہے 	Female
/content/drive/MyDrive/dataset/clips/268.wav	زور سے مت بولو	Female
/content/drive/MyDrive/dataset/clips/269.wav	 یہ مناسب وقت نہیں ہے 	Female
/content/drive/MyDrive/dataset/clips/270.wav	تم بہت سست ہو 	Female
/content/drive/MyDrive/dataset/clips/271.wav	ہاتھ مت لگاؤ	Male
/content/drive/MyDrive/dataset/clips/272.wav	 تمہارے الفاظ بہت تلخ ہیں	Male
/content/drive/MyDrive/dataset/clips/273.wav	 بہتر ہوگا تم چپ رہو 	Male
/content/drive/MyDrive/dataset/clips/274.wav	میڈم مجھے اتنی کم نمبر کیسے دے سکتی ہیں 	Male
/content/drive/MyDrive/dataset/clips/275.wav	تم مجھ پر کیوں چلا رہے ہو	Male
/content/drive/MyDrive/dataset/clips/276.wav	 تم نے میرا حق مارا ہے	Male
/content/drive/MyDrive/dataset/clips/277.wav	 تمہارے پاس ابھی بھی وقت ہے ٹھیک ہو جاؤ 	Male
/content/drive/MyDrive/dataset/clips/278.wav	ہوش سے کام لو 	Male
/content/drive/MyDrive/dataset/clips/279.wav	وہ تمہارا کیا لگتا ہے 	Male
/content/drive/MyDrive/dataset/clips/280.wav	وہ کام ہونے بھی دو اب	Male
/content/drive/MyDrive/dataset/clips/281.wav	 میں نہیں چاہتا تھا کہ یہ سب ہو	Female
/content/drive/MyDrive/dataset/clips/282.wav	 میں یہ نہیں سن سکتا 	Female
/content/drive/MyDrive/dataset/clips/283.wav	میں یہ نہیں چھپا سکتا 	Female
/content/drive/MyDrive/dataset/clips/284.wav	تم نے میرا مان توڑ دیا 	Female
/content/drive/MyDrive/dataset/clips/285.wav	یہ سب نہیں ہونا چاہیے تھا 	Female
/content/drive/MyDrive/dataset/clips/286.wav	خاموش ہو جاؤ 	Female
/content/drive/MyDrive/dataset/clips/287.wav	میں یہ نہیں سہہ سکتا 	Female
/content/drive/MyDrive/dataset/clips/288.wav	تم میری زندگی سے دور چلے جاؤ 	Female
/content/drive/MyDrive/dataset/clips/289.wav	تم آج باہر نہیں جا سکتے 	Female
/content/drive/MyDrive/dataset/clips/290.wav	مجھے بہت شدید غصہ آرہا ہے 	Female
/content/drive/MyDrive/dataset/clips/291.wav	ہمیں شرم سے ڈوب کے مر جانا چاہیے 	Female
/content/drive/MyDrive/dataset/clips/292.wav	تو مر کیوں نہیں جاتے 	Female
/content/drive/MyDrive/dataset/clips/293.wav	میرا پیچھا چھوڑ دو	Female
/content/drive/MyDrive/dataset/clips/294.wav	 یہ سب کیا ہے 	Female
/content/drive/MyDrive/dataset/clips/295.wav	ہم نے بے انصافی کردیں 	Female
/content/drive/MyDrive/dataset/clips/296.wav	تم نے مجھ پر ظلم کیا ہے 	Female
/content/drive/MyDrive/dataset/clips/297.wav	تم یہاں سے چلے جاؤ	Female
/content/drive/MyDrive/dataset/clips/298.wav	 مجھ سے دور ہو جاؤ ہمیشہ کے لیے	Female
/content/drive/MyDrive/dataset/clips/299.wav	 تم نے میرے ارادے کو بے اثر کر دیا	Female
/content/drive/MyDrive/dataset/clips/300.wav	ذلیل ہو گیا ہوں میں	Female
/content/drive/MyDrive/dataset/clips/301.wav	اگر میں ڈاکٹر ہوتا تو کیا تمہیں پھربھی ڈاکٹر سے نفرت ہوتی	Male
/content/drive/MyDrive/dataset/clips/302.wav	تمہیں کیوں نہ پسند  ہیںبینکرز	Male
/content/drive/MyDrive/dataset/clips/303.wav	کوئی تو وجہ ہوگی	Male
/content/drive/MyDrive/dataset/clips/304.wav	یہ کس بارے میں ہے	Male
/content/drive/MyDrive/dataset/clips/305.wav	لاؤنج کیسا لگ رہا ہے	Male
/content/drive/MyDrive/dataset/clips/306.wav	تو آج کا دن کیسا گزرا	Male
/content/drive/MyDrive/dataset/clips/307.wav	اتنے پیسے کہاں سے آئے	Male
/content/drive/MyDrive/dataset/clips/308.wav	اب اس کو بھی تم اتفاق کہو گی	Male
/content/drive/MyDrive/dataset/clips/309.wav	اب کیا میں تھوڑا سا کام کر لوں 	Male
/content/drive/MyDrive/dataset/clips/310.wav	میں یہاں سے کیسے آؤں گی	Male
/content/drive/MyDrive/dataset/clips/311.wav	کیا تم نے وہ فلم دیکھ لی 	Male
/content/drive/MyDrive/dataset/clips/312.wav	کیا وہ وہ بیمار  ہے 	Male
/content/drive/MyDrive/dataset/clips/313.wav	کیا اس نے کچھ نہیں کھایا 	Male
/content/drive/MyDrive/dataset/clips/314.wav	کیا اس نے امی سے پوچھا تھا 	Male
/content/drive/MyDrive/dataset/clips/315.wav	کیا اسے جاتے ہوئے دیکھا تم نے	Male
/content/drive/MyDrive/dataset/clips/316.wav	کیا اس نے میرے بارے میں پوچھا تھا 	Male
/content/drive/MyDrive/dataset/clips/317.wav	اس نے مجھے بلایا تھا وہ کہاں ہے	Male
/content/drive/MyDrive/dataset/clips/318.wav	کیا وہ ابھی تک گھر نہیں آیا 	Male
/content/drive/MyDrive/dataset/clips/319.wav	کیا وہ ہسپتال میں ہے 	Male
/content/drive/MyDrive/dataset/clips/320.wav	اس کو تم نے سمجھا دیا تھا	Male
/content/drive/MyDrive/dataset/clips/321.wav	گاڑی کی چابی کہاں ہے 	Female
/content/drive/MyDrive/dataset/clips/322.wav	ونڈوز کھولنے سے کوئی مسئلہ تو نہیں ہے 	Female
/content/drive/MyDrive/dataset/clips/323.wav	تم کس مرض کی دوا ہو	Female
/content/drive/MyDrive/dataset/clips/324.wav	پارکنگ کی جگہ کہاں ہے	Female
/content/drive/MyDrive/dataset/clips/325.wav	 آپ کہاں رہ گئے تھے	Female
/content/drive/MyDrive/dataset/clips/326.wav	کیا اس نے کچھ کہا 	Female
/content/drive/MyDrive/dataset/clips/327.wav	وہ آج کل کہاں رہتا ہے 	Female
/content/drive/MyDrive/dataset/clips/328.wav	کیا ایسا کرنے کی ضرورت تھی 	Female
/content/drive/MyDrive/dataset/clips/329.wav	تمہیں یقین ہے کہ کیا وہ سچ کہہ رہا ہے 	Female
/content/drive/MyDrive/dataset/clips/330.wav	ہو سکتا ہے اس نے ملاوٹ نہ کی ہو	Female
/content/drive/MyDrive/dataset/clips/331.wav	میں نے تم سے کوئی شکایت کی ہے 	Male
/content/drive/MyDrive/dataset/clips/332.wav	زخم گہرا تو نہیں تھا  	Male
/content/drive/MyDrive/dataset/clips/333.wav	تمہیں درد تو نہیں ہو رہا 	Male
/content/drive/MyDrive/dataset/clips/334.wav	ابو سے سے تمہاری کیا بات ہوئی	Male
/content/drive/MyDrive/dataset/clips/335.wav	پھر تم نے کیس کیوں ختم کیا	Male
/content/drive/MyDrive/dataset/clips/336.wav	کیا تمہیں بخار ہو رہا ہے	Male
/content/drive/MyDrive/dataset/clips/337.wav	تمہاری فیملی کو پتا ہے	Male
/content/drive/MyDrive/dataset/clips/338.wav	اس سب میں کیا قصور ہے میرا 	Male
/content/drive/MyDrive/dataset/clips/339.wav	تم نے دیکھا انہوں نے کیاکیا	Male
/content/drive/MyDrive/dataset/clips/340.wav	تم نے ساری باتیں سن لیں	Male
/content/drive/MyDrive/dataset/clips/341.wav	کیا جواب ہے	Female
/content/drive/MyDrive/dataset/clips/342.wav	تم کس طرح حل کرو گے اسے	Female
/content/drive/MyDrive/dataset/clips/343.wav	تم آخری رات کو کہاں گئے تھے	Female
/content/drive/MyDrive/dataset/clips/344.wav	ہمارے ساتھ اور کون آ رہا ہے 	Female
/content/drive/MyDrive/dataset/clips/345.wav	کیا تم اس میں میری مدد کرو گے	Female
/content/drive/MyDrive/dataset/clips/346.wav	تم نے ایسا کیوں کیا	Female
/content/drive/MyDrive/dataset/clips/347.wav	تم کتنے دنوں سے یہاں ہو	Female
/content/drive/MyDrive/dataset/clips/348.wav	تم نے دیکھا بھی کیا ہوا 	Female
/content/drive/MyDrive/dataset/clips/349.wav	ملاقات کب ہوگی	Female
/content/drive/MyDrive/dataset/clips/350.wav	تم نے گھر کب جاناہے	Female
/content/drive/MyDrive/dataset/clips/351.wav	 سچ کیا ایسا ہی ہے	Male
/content/drive/MyDrive/dataset/clips/352.wav	 تم یہاں کیوں آئے 	Male
/content/drive/MyDrive/dataset/clips/353.wav	کیا تم میں سے کسی نے فٹبال کھیلا	Male
/content/drive/MyDrive/dataset/clips/354.wav	 کیا بوتل میں دودھ بالکل نہیں ہے 	Male
/content/drive/MyDrive/dataset/clips/355.wav	آپ شادی کب کریں گے	Male
/content/drive/MyDrive/dataset/clips/356.wav	 تمہارے امتحان کب شروع ہوں گے 	Male
/content/drive/MyDrive/dataset/clips/357.wav	کل تم کہاں گئے تھے 	Male
/content/drive/MyDrive/dataset/clips/358.wav	کراچی کیوں جانا ہے 	Male
/content/drive/MyDrive/dataset/clips/359.wav	تمہارا گھر اور کتنا دور ہے 	Male
/content/drive/MyDrive/dataset/clips/360.wav	آپ کیا کر رہی ہیں 	Male
/content/drive/MyDrive/dataset/clips/361.wav	اس کار کا مالک کون ہے 	Female
/content/drive/MyDrive/dataset/clips/362.wav	کیا آپ نے مجھے بلایا تھا 	Female
/content/drive/MyDrive/dataset/clips/363.wav	کیا معاملہ ہے 	Female
/content/drive/MyDrive/dataset/clips/364.wav	دانش کہاں ہے 	Female
/content/drive/MyDrive/dataset/clips/365.wav	یہ کس کا کمرہ ہے 	Female
/content/drive/MyDrive/dataset/clips/366.wav	آپ کا کام کیسا چل رہا ہے	Female
/content/drive/MyDrive/dataset/clips/367.wav	 تم انگلش بول سکتے ہو 	Female
/content/drive/MyDrive/dataset/clips/368.wav	آپ کا دن کیسا رہا	Female
/content/drive/MyDrive/dataset/clips/369.wav	 میں جاؤ یا رک جاؤ 	Female
/content/drive/MyDrive/dataset/clips/370.wav	کہاں گئے تھے تم 	Female
/content/drive/MyDrive/dataset/clips/371.wav	تم کس مرض کی دوا ہو 	Male
/content/drive/MyDrive/dataset/clips/372.wav	آپ کہاں رہ گئے تھے	Male
/content/drive/MyDrive/dataset/clips/373.wav	 کیا وہ خیر خیریت سے پہنچ گئے	Male
/content/drive/MyDrive/dataset/clips/374.wav	 کتنی دفعہ میں آپ کو بتاؤں	Male
/content/drive/MyDrive/dataset/clips/375.wav	 کیا تمہیں ذرا بھی پرواہ نہیں ہے 	Male
/content/drive/MyDrive/dataset/clips/376.wav	میرے جوتے کہاں ہے	Male
/content/drive/MyDrive/dataset/clips/377.wav	 رات کے کھانے میں کیا ہے 	Male
/content/drive/MyDrive/dataset/clips/378.wav	کیا میں خوبصورت لگ رہی ہو 	Male
/content/drive/MyDrive/dataset/clips/379.wav	کیا آپ تھوڑا آہستہ بول سکتے ہیں	Male
/content/drive/MyDrive/dataset/clips/380.wav	 اسے اردو میں کیا کہتے ہیں	Male
/content/drive/MyDrive/dataset/clips/381.wav	 کیا آپ اسے خریدنا چاہتے ہیں 	Female
/content/drive/MyDrive/dataset/clips/382.wav	کیا یہ سچ ہے  	Female
/content/drive/MyDrive/dataset/clips/383.wav	تم نے یہ کیا	Female
/content/drive/MyDrive/dataset/clips/384.wav	 کیا تم نے سنا ہے 	Female
/content/drive/MyDrive/dataset/clips/385.wav	کیا آپ کی منزل یہ ہے 	Female
/content/drive/MyDrive/dataset/clips/386.wav	کیا آپ کو یہ پسند ہے	Female
/content/drive/MyDrive/dataset/clips/387.wav	 تم مجھ سے کتنا پیار کرتے ہو 	Female
/content/drive/MyDrive/dataset/clips/388.wav	تم میرے لیے کیا کر سکتے ہو 	Female
/content/drive/MyDrive/dataset/clips/389.wav	تمہیں سمجھ کیوں نہیں آتی	Female
/content/drive/MyDrive/dataset/clips/390.wav	 تم راضی ہو 	Female
/content/drive/MyDrive/dataset/clips/391.wav	تم کہاں جارہے ہو	Female
/content/drive/MyDrive/dataset/clips/392.wav	 کیا تم مجھے پسند کرتے ہو 	Female
/content/drive/MyDrive/dataset/clips/393.wav	اس لیب میں کون ہے 	Female
/content/drive/MyDrive/dataset/clips/394.wav	کیا تم کل لاہور جاؤ گے	Female
/content/drive/MyDrive/dataset/clips/395.wav	 کب میری مدد کرو گے 	Female
/content/drive/MyDrive/dataset/clips/396.wav	کیا تم نے میرا ساتھ دیا	Female
/content/drive/MyDrive/dataset/clips/397.wav	 کیا تم نا خوش ہو 	Female
/content/drive/MyDrive/dataset/clips/398.wav	کیا تم نے ڈیبی کی اسائنمنٹ کر لی 	Female
/content/drive/MyDrive/dataset/clips/399.wav	پاکستان کا سب سے بڑا ضلع کونسا ہے	Female
/content/drive/MyDrive/dataset/clips/400.wav	کیا تم پاکستان میں رہتے ہو	Female
/content/drive/MyDrive/dataset/clips/401.wav	تم نے مجھے ڈرا دیا تھا	Male
/content/drive/MyDrive/dataset/clips/402.wav	تمہارا چہرہ سرخ کیوں ہے	Male
/content/drive/MyDrive/dataset/clips/403.wav	اس نے کہا تھا  موت جیسی تکلیف ہوگی	Male
/content/drive/MyDrive/dataset/clips/404.wav	اسے کچھ دن پہلے کا سفر یاد آیا تھا 	Male
/content/drive/MyDrive/dataset/clips/405.wav	یہ جگہ یاد ہی ہوگی تمہیں یاد  ہی یونی چاہیے 	Male
/content/drive/MyDrive/dataset/clips/406.wav	لیکن اس نے گولیاں کہاں سے لی پسٹل تو خالی تھا	Male
/content/drive/MyDrive/dataset/clips/407.wav	تم ڈر گئے تھے	Male
/content/drive/MyDrive/dataset/clips/408.wav	تمہاری طبیعت ٹھیک ہے کیا 	Male
/content/drive/MyDrive/dataset/clips/409.wav	مجھے ڈر لگتا ہے میں تمہارے ساتھ جاؤں گی	Male
/content/drive/MyDrive/dataset/clips/410.wav	تمہیں انجام کا انتظار کرنا چاہیے	Male
/content/drive/MyDrive/dataset/clips/411.wav	مجھے بہت ڈر لگا جب میں نے کتوں کی آوازیں سنیں	Male
/content/drive/MyDrive/dataset/clips/412.wav	چھپکلی سے مجھے ڈر لگتا ہے	Male
/content/drive/MyDrive/dataset/clips/413.wav	سنا ہے اس کو کسی نے قتل کر دیا 	Male
/content/drive/MyDrive/dataset/clips/414.wav	کسی نے میرا پیچھا کیا	Male
/content/drive/MyDrive/dataset/clips/415.wav	ان کے گھر چوری ہوئی  	Male
/content/drive/MyDrive/dataset/clips/416.wav	رات ک اس گھرسےعجیب آوازیں آتی ہے 	Male
/content/drive/MyDrive/dataset/clips/417.wav	بہت سی آوازیں آتی ہیں راستےمیں جنگل سے گزرتے ہوئے	Male
/content/drive/MyDrive/dataset/clips/418.wav	وہ پھر بھی ٹھیک نہیں ہوئ	Male
/content/drive/MyDrive/dataset/clips/419.wav	مجھےاس کمرےمیں اکیلا نہیں جانا چاہیے	Male
/content/drive/MyDrive/dataset/clips/420.wav	اس پر سایہ ہے	Male
/content/drive/MyDrive/dataset/clips/421.wav	ایٹم بم بہت خوفناک ایجاد ہے 	Female
/content/drive/MyDrive/dataset/clips/422.wav	مجھے ایسےگھروں میں جانے سے ڈر لگتا ہے	Female
/content/drive/MyDrive/dataset/clips/423.wav	وہ بہت گھبرایا ہوا ہے 	Female
/content/drive/MyDrive/dataset/clips/424.wav	اس طیارے میں انجان لوگ ہیں 	Female
/content/drive/MyDrive/dataset/clips/425.wav	تمہیں ایسا نہیں کرنا چاہیے تھا 	Female
/content/drive/MyDrive/dataset/clips/426.wav	انجام کے لیئے اسے اب تیار رہنا چاہیے	Female
/content/drive/MyDrive/dataset/clips/427.wav	میں بہت خوف زدہ ہوں 	Female
/content/drive/MyDrive/dataset/clips/428.wav	اس نے مجھے تھپڑ مارا 	Female
/content/drive/MyDrive/dataset/clips/429.wav	یاد رکھنا میں تمہیں دیکھ لوں گااس نے یہی کہا تھا 	Female
/content/drive/MyDrive/dataset/clips/430.wav	وہاں بہت سارے لوگ تھے	Female
/content/drive/MyDrive/dataset/clips/431.wav	وہ جانتا ہے تم ڈر گئی	Male
/content/drive/MyDrive/dataset/clips/432.wav	ہم یہاں کسی اور کی تلاش کرنے نہیں آئے تمہارے لیے آئے	Male
/content/drive/MyDrive/dataset/clips/433.wav	دروازہ بند کر دو	Male
/content/drive/MyDrive/dataset/clips/434.wav	میں ہمت نہیں کر پا رہی	Male
/content/drive/MyDrive/dataset/clips/435.wav	میں بات کو کیسے شروع کروں	Male
/content/drive/MyDrive/dataset/clips/436.wav	مجھے یہاں سے بھاگنا چاہیے	Male
/content/drive/MyDrive/dataset/clips/437.wav	یہ تصویریں اس سے خوفزدہ کر رہی تھی 	Male
/content/drive/MyDrive/dataset/clips/438.wav	یہ صرف پیسوں کا معاملہ نہیں لگ رہا	Male
/content/drive/MyDrive/dataset/clips/439.wav	تمہیں بھی بات کرتے وقت احتیاط کرنی چاہیے تھی	Male
/content/drive/MyDrive/dataset/clips/440.wav	پلک جھپکتے ہی وہ وہاں سے غائب ہو گیا	Male
/content/drive/MyDrive/dataset/clips/441.wav	میں محفوظ نہیں ہوں 	Female
/content/drive/MyDrive/dataset/clips/442.wav	مجھے ڈر لگ رہا ہے	Female
/content/drive/MyDrive/dataset/clips/443.wav	میرا دل دھڑک رہا ہے 	Female
/content/drive/MyDrive/dataset/clips/444.wav	یہ تو بہت خوفناک ہے	Female
/content/drive/MyDrive/dataset/clips/445.wav	یہ مجھے کوئی حوصلہ نہیں دے رہا بلکہ ڈرا رہا ہے	Female
/content/drive/MyDrive/dataset/clips/446.wav	آگے کا دور انسانوں کو مشین بنا دے گا	Female
/content/drive/MyDrive/dataset/clips/447.wav	دل کرتا ہے بھاگ جاؤں کیوں کہ عجیب آوازیں آ رہی ہیں	Female
/content/drive/MyDrive/dataset/clips/448.wav	محسوس ہو رہا ہے کچھ ہونے والا ہے 	Female
/content/drive/MyDrive/dataset/clips/449.wav	تمہیں ہر چیز ان کی مرضی سے کرنی چاہیے	Female
/content/drive/MyDrive/dataset/clips/450.wav	مجھے ڈر ہے کہ کچھ غلط نہ ہو جائے	Female
/content/drive/MyDrive/dataset/clips/451.wav	 مجھے کتوں سے ڈر لگتا ہے 	Male
/content/drive/MyDrive/dataset/clips/452.wav	اس بیماری کا بہت خدشہ ہے 	Male
/content/drive/MyDrive/dataset/clips/453.wav	مجھے اندھیرے سے خوف آتا ہے 	Male
/content/drive/MyDrive/dataset/clips/454.wav	وہ مجھے مار ڈالے گا	Male
/content/drive/MyDrive/dataset/clips/455.wav	 دروازہ کون کھٹکھٹا رہا ہے 	Male
/content/drive/MyDrive/dataset/clips/456.wav	سب تمہاری وجہ سے ہوا ہے	Male
/content/drive/MyDrive/dataset/clips/457.wav	 وہ شخص اعتبار کے قابل نہیں ہے	Male
/content/drive/MyDrive/dataset/clips/458.wav	 پلیز میری مدد کرو 	Male
/content/drive/MyDrive/dataset/clips/459.wav	مجھے تنہا مت چھوڑو 	Male
/content/drive/MyDrive/dataset/clips/460.wav	بہت بڑا مسئلہ کھڑا ہوگیا ہے 	Male
/content/drive/MyDrive/dataset/clips/461.wav	یہ دوائی بہت کڑوی ہے 	Female
/content/drive/MyDrive/dataset/clips/462.wav	کیا ہم اس ٹیکسی ڈرائیور پر بھروسہ کر سکتے ہیں 	Female
/content/drive/MyDrive/dataset/clips/463.wav	آپ کو بتانا ضروری نہیں 	Female
/content/drive/MyDrive/dataset/clips/464.wav	اقرا کی بھائی کی موت ہوگئی 	Female
/content/drive/MyDrive/dataset/clips/465.wav	میں تمہیں پیسے دے دوں گا ی	Female
/content/drive/MyDrive/dataset/clips/466.wav	ہ تو ایسے ہی زبان سے نکل گیا 	Female
/content/drive/MyDrive/dataset/clips/467.wav	کچھ گڑبڑ ہے 	Female
/content/drive/MyDrive/dataset/clips/468.wav	میں کسی کو یقین نہیں کر سکتا 	Female
/content/drive/MyDrive/dataset/clips/469.wav	خدا کا واسطہ ہے پیچھے ہٹ جاؤ 	Female
/content/drive/MyDrive/dataset/clips/470.wav	کہنے کے لیے کچھ بھی نہیں 	Female
/content/drive/MyDrive/dataset/clips/471.wav	میری بات غور سے سنو 	Male
/content/drive/MyDrive/dataset/clips/472.wav	میں بولتے بولتے رہ گیا 	Male
/content/drive/MyDrive/dataset/clips/473.wav	میں یہ سب تمہارے سامنے نہیں کہہ سکتا 	Male
/content/drive/MyDrive/dataset/clips/474.wav	مجھ پر بہت مشکل وقت آیا ہے 	Male
/content/drive/MyDrive/dataset/clips/475.wav	آپ نے پوچھا بھی نہیں 	Male
/content/drive/MyDrive/dataset/clips/476.wav	وہ بدمعاش آدمی ہے	Male
/content/drive/MyDrive/dataset/clips/477.wav	 مجھے تمہاری تلاش تھی 	Male
/content/drive/MyDrive/dataset/clips/478.wav	آپ کی کمی بہت محسوس ہوتی ہے مجھے 	Male
/content/drive/MyDrive/dataset/clips/479.wav	میں کھو گیا ہوں	Male
/content/drive/MyDrive/dataset/clips/480.wav	میں عاصم کو ہی ڈھونڈ رہا ہوں	Male
/content/drive/MyDrive/dataset/clips/481.wav	 میں ڈر گیا ہوں	Female
/content/drive/MyDrive/dataset/clips/482.wav	 مجھے شکایت ہے خوف کی	Female
/content/drive/MyDrive/dataset/clips/483.wav	 میں خوف زدہ ہوں 	Female
/content/drive/MyDrive/dataset/clips/484.wav	 مجھے مرنے سے بہت ڈر لگتا ہے	Female
/content/drive/MyDrive/dataset/clips/485.wav	مجھے گھبراہٹ ہو رہی ہے	Female
/content/drive/MyDrive/dataset/clips/486.wav	 مجھے لگتا ہے کچھ برا ہونے والا ہے 	Female
/content/drive/MyDrive/dataset/clips/487.wav	مجھے اونچائی سے بہت ڈر لگتا ہے	Female
/content/drive/MyDrive/dataset/clips/488.wav	 کوئی مجھ کو بچائے 	Female
/content/drive/MyDrive/dataset/clips/489.wav	میں نہیں جانتا کیا ہوگیا 	Female
/content/drive/MyDrive/dataset/clips/490.wav	میرا دل بہت تیزی سے دھڑک رہا ہے	Female
/content/drive/MyDrive/dataset/clips/491.wav	  اس سے پہلے کچھ برا ہوں مجھے دور لے جاؤ 	Female
/content/drive/MyDrive/dataset/clips/492.wav	مجھے ڈر ہے وہ خود کو نقصان پہنچ جائے گا 	Female
/content/drive/MyDrive/dataset/clips/493.wav	کسی انجان کے ساتھ اکیلے سفر مت کرنا 	Female
/content/drive/MyDrive/dataset/clips/494.wav	میری زندگی خطرے میں ہے 	Female
/content/drive/MyDrive/dataset/clips/495.wav	جنگل میں رات کا کہ رہی تھی پھر اچانک شیر آ گیا 	Female
/content/drive/MyDrive/dataset/clips/496.wav	میری زندگی کا سوال ہے 	Female
/content/drive/MyDrive/dataset/clips/497.wav	میں بہت خطرناک کھیل میں ہوں	Female
/content/drive/MyDrive/dataset/clips/498.wav	مجھے ڈر ہے میں اسے کھو نہ دوں	Female
/content/drive/MyDrive/dataset/clips/499.wav	 اگر وہ مر گیا تو 	Female
/content/drive/MyDrive/dataset/clips/500.wav	مجھے کوئی نہیں بچانے والا	Female
/content/drive/MyDrive/dataset/clips/501.wav	اوہ خدایا یا  تم کیا کیا سوچتی ہو 	Male
/content/drive/MyDrive/dataset/clips/502.wav	تم بہت بدل گئے ہو واقعی میں 	Male
/content/drive/MyDrive/dataset/clips/503.wav	تم مجھے ایسے کیوں دیکھ رہی ہو 	Male
/content/drive/MyDrive/dataset/clips/504.wav	سبق سکھائے ہوں گے گڈ نہیں 	Male
/content/drive/MyDrive/dataset/clips/505.wav	یہ میرے لیےایک  بڑی خبر ہے 	Male
/content/drive/MyDrive/dataset/clips/506.wav	یہ سب بہت عجیب لوگ ہیں	Male
/content/drive/MyDrive/dataset/clips/507.wav	اس جھیل میں میں پانی کہاں سے آئے گا	Male
/content/drive/MyDrive/dataset/clips/508.wav	میں تمہیں جھیل کیسے بنا کے دونگا	Male
/content/drive/MyDrive/dataset/clips/509.wav	تم جسٹیفائی  کر رہے ہوسود کو 	Male
/content/drive/MyDrive/dataset/clips/510.wav	شکر ہے تم مجھے یہاں لے کرآئے	Male
/content/drive/MyDrive/dataset/clips/511.wav	ہماری بلی نے چھپکلی کھا لی 	Male
/content/drive/MyDrive/dataset/clips/512.wav	تمہارا مطلب کیا ہے اس بات سے	Male
/content/drive/MyDrive/dataset/clips/513.wav	بجلی کی قیمت بہت بڑھ گئی ہے 	Male
/content/drive/MyDrive/dataset/clips/514.wav	اس نے خود کشی کرلی 	Male
/content/drive/MyDrive/dataset/clips/515.wav	اس کے بھائی کا حادثہ ہوا	Male
/content/drive/MyDrive/dataset/clips/516.wav	تمہیں یقین ہے کہ وہ واپس دیر سے آیا تھا	Male
/content/drive/MyDrive/dataset/clips/517.wav	اس کے ابو نے اسے سخت سزا دی ہے	Male
/content/drive/MyDrive/dataset/clips/518.wav	ایسا کیسے ہو سکتا ہے	Male
/content/drive/MyDrive/dataset/clips/519.wav	وہ رساکشی میں بھی ہار سکتا ہے کافی حیران کن ہے 	Male
/content/drive/MyDrive/dataset/clips/520.wav	تمہیں حساب میں پاس ہونے کے لیےدوبارہ امتحان دینا ہے	Male
/content/drive/MyDrive/dataset/clips/521.wav	کیا اس نے واقعی ایسا کیا	Female
/content/drive/MyDrive/dataset/clips/522.wav	ابوآج لاہورسے واپس آ گئے	Female
/content/drive/MyDrive/dataset/clips/523.wav	میری امی کی لاٹری نکلی	Female
/content/drive/MyDrive/dataset/clips/524.wav	میرے بھائی نے پہلی پوزیشن حاصل کی 	Female
/content/drive/MyDrive/dataset/clips/525.wav	میری بہن نے لاہور سے دو دن پہلےآکرہم کو حیران کردیا	Female
/content/drive/MyDrive/dataset/clips/526.wav	تمہارے لباس کافی کی قیمتیں ہیں 	Female
/content/drive/MyDrive/dataset/clips/527.wav	تم اندازہ بھی نہیں لگا سکتی تمہیں یہاں د یکھ کر کتنی خوشی ہوئی	Female
/content/drive/MyDrive/dataset/clips/528.wav	حیرت کی بات ہے کہ اس نے یہ کام کر لیا 	Female
/content/drive/MyDrive/dataset/clips/529.wav	حیران نہ ہو ں یہ کانپورہی ہے 	Female
/content/drive/MyDrive/dataset/clips/530.wav	یہ کیسے ہوا مجھے کچھ علم نہیں	Female
/content/drive/MyDrive/dataset/clips/531.wav	یعنی میرا کہا نہیں مانوں گے تم  	Male
/content/drive/MyDrive/dataset/clips/532.wav	اس کے ساتھ کیا واقعی یہ حادثہ ہوا	Male
/content/drive/MyDrive/dataset/clips/533.wav	تو یہاں ارادہ بدلنے کی ضرورت نہیں ہے	Male
/content/drive/MyDrive/dataset/clips/534.wav	یہ فارمولا کافی دلچسپ اور حیران کن ہے	Male
/content/drive/MyDrive/dataset/clips/535.wav	اس کو حیرت تھی کہ وہ اس سے پہلے کیوں نہیں ملے 	Male
/content/drive/MyDrive/dataset/clips/536.wav	اس کی ذہانت سے سب متاثر تھے	Male
/content/drive/MyDrive/dataset/clips/537.wav	تمہیں سوچ کے بولنا چاہیے 	Male
/content/drive/MyDrive/dataset/clips/538.wav	تمہاری عادتیں بالکل بھی نہیں بدلی 	Male
/content/drive/MyDrive/dataset/clips/539.wav	انکار کی کوئی تو وجہ ہوگی	Male
/content/drive/MyDrive/dataset/clips/540.wav	کیا تم نے واقعی اس کا پروپوزل نہیں قبول کیا	Male
/content/drive/MyDrive/dataset/clips/541.wav	مجھے یقین نہیں ہوتا تم نے یہ کیا 	Female
/content/drive/MyDrive/dataset/clips/542.wav	یہ ناقابل یقین ہے	Female
/content/drive/MyDrive/dataset/clips/543.wav	میں حیران ہو گیا ہوں 	Female
/content/drive/MyDrive/dataset/clips/544.wav	میں تو یہ سوچ بھی نہیں سکتا 	Female
/content/drive/MyDrive/dataset/clips/545.wav	یہ کیا حالات ہو گئےہیں   	Female
/content/drive/MyDrive/dataset/clips/546.wav	میں نے اتنا نہیں سوچا تھا	Female
/content/drive/MyDrive/dataset/clips/547.wav	میں سوچ بھی نہیں سکتا تھا کہ تم ایسا کرو  گے	Female
/content/drive/MyDrive/dataset/clips/548.wav	مجھے سمجھ نہیں آرہی کہ کیا کروں	Female
/content/drive/MyDrive/dataset/clips/549.wav	یہ کیسے ہوگیا 	Female
/content/drive/MyDrive/dataset/clips/550.wav	یہ کافی عجیب بات ہے	Female
/content/drive/MyDrive/dataset/clips/551.wav	 میں تم سے بہت متاثر ہوں 	Male
/content/drive/MyDrive/dataset/clips/552.wav	آپ کو یہاں دیکھ کر بہت خوشی ہوئی	Male
/content/drive/MyDrive/dataset/clips/553.wav	 مجھے اچانک پارٹی کا سن کر تعجب ہوا	Male
/content/drive/MyDrive/dataset/clips/554.wav	 باقی سب سے اپنا وعدہ پورا کر دکھایا ہے	Male
/content/drive/MyDrive/dataset/clips/555.wav	 میرے خیال سے ہم پہلے مل چکے ہیں 	Male
/content/drive/MyDrive/dataset/clips/556.wav	مجمع میں ہر کوئی حیران کھڑا تھا 	Male
/content/drive/MyDrive/dataset/clips/557.wav	آپ سے مل کر بہت خوشی ہوئی 	Male
/content/drive/MyDrive/dataset/clips/558.wav	یہ ممکن نہیں تھا لیکن تم نے کر دکھایا 	Male
/content/drive/MyDrive/dataset/clips/559.wav	میری سالگرہ کا تحفہ بہت الگ تھا	Male
/content/drive/MyDrive/dataset/clips/560.wav	 میرے ساتھ راستے پر ایک حیرت انگیز واقعہ پیش آیا 	Male
/content/drive/MyDrive/dataset/clips/561.wav	تم فوراً واپس آ گئے	Female
/content/drive/MyDrive/dataset/clips/562.wav	 مجھے معلوم تھا 	Female
/content/drive/MyDrive/dataset/clips/563.wav	کیا تم ایک گاندھی جی پسند ہے	Female
/content/drive/MyDrive/dataset/clips/564.wav	 تم بھی ایسا کر سکتے ہو 	Female
/content/drive/MyDrive/dataset/clips/565.wav	آنکھیں ترس گئیں تو میں دیکھنے کے لئے 	Female
/content/drive/MyDrive/dataset/clips/566.wav	وہ کنگال ہو گیا 	Female
/content/drive/MyDrive/dataset/clips/567.wav	تمہیں مجھ سے کوئی کام تھا 	Female
/content/drive/MyDrive/dataset/clips/568.wav	تم مجھے کیسے یاد کر سکتے ہو 	Female
/content/drive/MyDrive/dataset/clips/569.wav	وہ تمہارا کچھ لگتا ہے کیا 	Female
/content/drive/MyDrive/dataset/clips/570.wav	اس کا نام عزیز ہے لگتا نہیں 	Female
/content/drive/MyDrive/dataset/clips/571.wav	کیا آج ہم شاپنگ پر جا رہے ہیں 	Male
/content/drive/MyDrive/dataset/clips/572.wav	مجھے جس کا انتظار تھا آخر کار وہ مجھے مل گئی گی 	Male
/content/drive/MyDrive/dataset/clips/573.wav	یوں اچانک آپ مجھے حیران کر دیا	Male
/content/drive/MyDrive/dataset/clips/574.wav	 بچوں آج آپ کی خالہ آ رہی ہے	Male
/content/drive/MyDrive/dataset/clips/575.wav	 کھیلنے کا ٹائم ہونے والا ہے	Male
/content/drive/MyDrive/dataset/clips/576.wav	 ہم کل سیر کو جا رہے ہیں 	Male
/content/drive/MyDrive/dataset/clips/577.wav	میں نے پورے سکول میں ٹاپ کیا ہے	Male
/content/drive/MyDrive/dataset/clips/578.wav	 ہم اسے ایک برتھ ڈے پارٹی دینے والے ہیں	Male
/content/drive/MyDrive/dataset/clips/579.wav	 مجھے تم سے یہ امید نہیں تھی 	Male
/content/drive/MyDrive/dataset/clips/580.wav	میں سوچ بھی نہیں سکتی تو میں ایسا کر سکتی ہو	Male
/content/drive/MyDrive/dataset/clips/581.wav	 میں حیران ہوں 	Female
/content/drive/MyDrive/dataset/clips/582.wav	میں اتنی بڑی خوشی کی خبر کا سوچ بھی نہیں سکتی تھی 	Female
/content/drive/MyDrive/dataset/clips/583.wav	میں یہ جاننا چاہتا ہوں 	Female
/content/drive/MyDrive/dataset/clips/584.wav	تم نے بہت محنت کی ہے اس کے لیے 	Female
/content/drive/MyDrive/dataset/clips/585.wav	مجھے تم سے اس برتاؤ کی امید نہیں تھی	Female
/content/drive/MyDrive/dataset/clips/586.wav	 مجھے تو سوچ کر بھی حیرانی ہو رہی ہے کو	Female
/content/drive/MyDrive/dataset/clips/587.wav	 یہ سمجھ ہی نہیں پا رہا ہے 	Female
/content/drive/MyDrive/dataset/clips/588.wav	یہ سب میرے لئے کیا ہے 	Female
/content/drive/MyDrive/dataset/clips/589.wav	یہ کیسے ہوگیا 	Female
/content/drive/MyDrive/dataset/clips/590.wav	واہ ایسے کیسے کر سکتا ہے 	Female
/content/drive/MyDrive/dataset/clips/591.wav	اس بات سے انجان تھا 	Female
/content/drive/MyDrive/dataset/clips/592.wav	یہ کیا ہو رہا ہے 	Female
/content/drive/MyDrive/dataset/clips/593.wav	کیا تم خاص میرے لئے آئے ہو 	Female
/content/drive/MyDrive/dataset/clips/594.wav	وہ ہار نہیں سکتا 	Female
/content/drive/MyDrive/dataset/clips/595.wav	یہ میرے لئے بہت حیرت انگیز بات ہے 	Female
/content/drive/MyDrive/dataset/clips/596.wav	مجھے کچھ سمجھ ہی نہیں آ رہی تھی 	Female
/content/drive/MyDrive/dataset/clips/597.wav	تم کب واپس آئے 	Female
/content/drive/MyDrive/dataset/clips/598.wav	یوں اچانک یہ سب کیسے ہوگیا 	Female
/content/drive/MyDrive/dataset/clips/599.wav	یہ سب کچھ میرے لئے نیا تھا 	Female
/content/drive/MyDrive/dataset/clips/600.wav	کیا ہم واقعی میچ جیت گئے ہیں	Female
/content/drive/MyDrive/dataset/clips/601.wav	ہائیکنگ بہت تحریللنگ ہوگئ	Male
/content/drive/MyDrive/dataset/clips/602.wav	مجھے یہ اندازہ نہیں تھا کہ یہ اتنا اچھا ہوگا	Male
/content/drive/MyDrive/dataset/clips/603.wav	میں کیوں اچھی لگتی ہو تمہیں وضاحت کرو	Male
/content/drive/MyDrive/dataset/clips/604.wav	میرا ٹریپ تو اچھا رہے گا	Male
/content/drive/MyDrive/dataset/clips/605.wav	میں پلین میں آرام کروں گا 	Male
/content/drive/MyDrive/dataset/clips/606.wav	میں ایک دو پیکنگز مکمل کرونگی	Male
/content/drive/MyDrive/dataset/clips/607.wav	یعنی تم عید پر آؤ گے	Male
/content/drive/MyDrive/dataset/clips/608.wav	آج کھانے میں ضرور کچھ اچھا بنا ہوگا	Male
/content/drive/MyDrive/dataset/clips/609.wav	آج کون سے کپڑے پہنوں	Male
/content/drive/MyDrive/dataset/clips/610.wav	یہ کلر میں نے صرف اس تقریب کے لئے رکھا ہوا تھا	Male
/content/drive/MyDrive/dataset/clips/611.wav	یہ گیم بہت پر جوش ہونے والی ہے 	Male
/content/drive/MyDrive/dataset/clips/612.wav	میں سو بھی نہیں سگی میں اتنی خوش تھی	Male
/content/drive/MyDrive/dataset/clips/613.wav	آڈینس بھی بہت پرجوش ہے	Male
/content/drive/MyDrive/dataset/clips/614.wav	ہمیں مزہ آئے گا فلم دیکھ کر	Male
/content/drive/MyDrive/dataset/clips/615.wav	ہاں بالکل تم نے صحیح مشورہ دیا 	Male
/content/drive/MyDrive/dataset/clips/616.wav	اس بار مری جانے کا ارادہ ہے 	Male
/content/drive/MyDrive/dataset/clips/617.wav	اس کا ردعمل سن کر عجیب نہیں لگا	Male
/content/drive/MyDrive/dataset/clips/618.wav	وہ کب تک آ جائیں گے مجھے انتظار ہے 	Male
/content/drive/MyDrive/dataset/clips/619.wav	میں نے اس کی پسند کا سب کچھ بنا دیا 	Male
/content/drive/MyDrive/dataset/clips/620.wav	یقینا یہ سب اچھا رہے گا	Male
/content/drive/MyDrive/dataset/clips/621.wav	آج ہمارے گھر مہمان آ رہے ہیں 	Female
/content/drive/MyDrive/dataset/clips/622.wav	میں کھیلوں میں حصہ ضرور لوں گی 	Female
/content/drive/MyDrive/dataset/clips/623.wav	میں یہ سن کر بہت خوش ہوں	Female
/content/drive/MyDrive/dataset/clips/624.wav	وہ سب ٹرین پر آرہے ہیں	Female
/content/drive/MyDrive/dataset/clips/625.wav	پتانہیں سفر کیسا رہے گا	Female
/content/drive/MyDrive/dataset/clips/626.wav	بریانی میری پسندیدہ غذا ہے 	Female
/content/drive/MyDrive/dataset/clips/627.wav	تم جانتے ہو میں نے کل رات ایک خواب دیکھا 	Female
/content/drive/MyDrive/dataset/clips/628.wav	ہم نے نیا گھر تعمیر کروایا ہے 	Female
/content/drive/MyDrive/dataset/clips/629.wav	یہ پھول جب کھل جائیں گے تو بہت خوبصورت ہوں گے 	Female
/content/drive/MyDrive/dataset/clips/630.wav	آرٹ کی تقریبات میں جا کر اچھا محسوس ہوگا	Female
/content/drive/MyDrive/dataset/clips/631.wav	میں بھی جاؤں گی پارک میں ان کے ساتھ	Male
/content/drive/MyDrive/dataset/clips/632.wav	یہ رنگ تو بہت خوبصورت ہے 	Male
/content/drive/MyDrive/dataset/clips/633.wav	تمہارے لئے میرے پاس ایک اچھی خبر ہے اور ایک بری بھی	Male
/content/drive/MyDrive/dataset/clips/634.wav	پتا نہیں وہ کیوں اتنی خوش تھی 	Male
/content/drive/MyDrive/dataset/clips/635.wav	میرے لیے یہ پہلا تجربہ ہوگا	Male
/content/drive/MyDrive/dataset/clips/636.wav	تصویریں بہت خوبصورت آئی ہیں 	Male
/content/drive/MyDrive/dataset/clips/637.wav	میں نے دو گھنٹے انتظار کیا 	Male
/content/drive/MyDrive/dataset/clips/638.wav	ہم نے یہ کارنامہ بھی کر دیا 	Male
/content/drive/MyDrive/dataset/clips/639.wav	نتیجہ یقین اچھا ہی ہوگا	Male
/content/drive/MyDrive/dataset/clips/640.wav	یہ سفر طے کرنے کے بعد پتہ چلے گا کہ کون خوش تھا اور کون ناراض	Male
/content/drive/MyDrive/dataset/clips/641.wav	یہ تو بہت شاندار ہے 	Female
/content/drive/MyDrive/dataset/clips/642.wav	میں بہت پرجوش ہوں 	Female
/content/drive/MyDrive/dataset/clips/643.wav	میں دن گن رہا ہوں کہ کب یہ ہوگا 	Female
/content/drive/MyDrive/dataset/clips/644.wav	میں سچ میں خوش ہوں 	Female
/content/drive/MyDrive/dataset/clips/645.wav	میں انتظار نہیں کر پارہاہوں 	Female
/content/drive/MyDrive/dataset/clips/646.wav	میں چاند پر سفر کر رہاہوں 	Female
/content/drive/MyDrive/dataset/clips/647.wav	میں خوشی میں دیواریں ٹاپ رہا ہوں 	Female
/content/drive/MyDrive/dataset/clips/648.wav	یہ میرے خوابوں سے بھی آگے ہے 	Female
/content/drive/MyDrive/dataset/clips/649.wav	یہ بہت مزے دار ہونے والا ہے 	Female
/content/drive/MyDrive/dataset/clips/650.wav	یہ ایسےہو جیسے کوئی خواب سچ ہو گیا	Female
/content/drive/MyDrive/dataset/clips/651.wav	 میں نے یہ انعام جیت لیا 	Male
/content/drive/MyDrive/dataset/clips/652.wav	یہ مبارک دن بار بار آئے 	Male
/content/drive/MyDrive/dataset/clips/653.wav	یہ منظر کتنا خوبصورت ہے	Male
/content/drive/MyDrive/dataset/clips/654.wav	 برائے مہربانی جلدی کیجئے	Male
/content/drive/MyDrive/dataset/clips/655.wav	 کیا یہ سچ ہے	Male
/content/drive/MyDrive/dataset/clips/656.wav	 آپ نے تو کمال کر دیا	Male
/content/drive/MyDrive/dataset/clips/657.wav	 یہ کتنی خوشی کی بات ہے 	Male
/content/drive/MyDrive/dataset/clips/658.wav	واہ واہ کیا بات ہے 	Male
/content/drive/MyDrive/dataset/clips/659.wav	یہ تو بڑی خوشی کی خبر ہے 	Male
/content/drive/MyDrive/dataset/clips/660.wav	خبردار ہوشیار رہیں 	Male
/content/drive/MyDrive/dataset/clips/661.wav	اگلے مہینے میری منگنی ہے 	Female
/content/drive/MyDrive/dataset/clips/662.wav	آپ کی دعوت کا بہت شکریہ 	Female
/content/drive/MyDrive/dataset/clips/663.wav	ہم سب تیار ہیں 	Female
/content/drive/MyDrive/dataset/clips/664.wav	وہ بہت پرجوش لگ رہا ہے	Female
/content/drive/MyDrive/dataset/clips/665.wav	 شوق کا کوئی مول نہیں 	Female
/content/drive/MyDrive/dataset/clips/666.wav	میرا کوئز بہت اچھا ہوا 	Female
/content/drive/MyDrive/dataset/clips/667.wav	میں کلاس میں اول آیا 	Female
/content/drive/MyDrive/dataset/clips/668.wav	واو میرا سوٹ تیار ہے 	Female
/content/drive/MyDrive/dataset/clips/669.wav	میں خوشی سے پاگل ہو جاؤں گا 	Female
/content/drive/MyDrive/dataset/clips/670.wav	واہ آج کھانا ابو بنائیں گے 	Female
/content/drive/MyDrive/dataset/clips/671.wav	میں ٹھیک ہوں بہت شکریہ 	Male
/content/drive/MyDrive/dataset/clips/672.wav	آپ بہت مہربان ہو	Male
/content/drive/MyDrive/dataset/clips/673.wav	 میں پرسوں امریکہ جا رہا ہوں 	Male
/content/drive/MyDrive/dataset/clips/674.wav	آپ تو بہت اچھی انگریزی بول لیتی ہیں 	Male
/content/drive/MyDrive/dataset/clips/675.wav	واہ آپ کو میرا نام ایک جیسا ہے	Male
/content/drive/MyDrive/dataset/clips/676.wav	 تھوڑی سی دیر اور انجوائے کرنے دیں 	Male
/content/drive/MyDrive/dataset/clips/677.wav	میں بہت جلدی اپنی انجینئرنگ مکمل کر لو گی	Male
/content/drive/MyDrive/dataset/clips/678.wav	 میرے گھر آج مہمان آ رہے ہیں 	Male
/content/drive/MyDrive/dataset/clips/679.wav	ہم سب کزن مل کر کھیلیں گے	Male
/content/drive/MyDrive/dataset/clips/680.wav	 مجھے ماموں کے گھر جانا ہے 	Male
/content/drive/MyDrive/dataset/clips/681.wav	 وہ بہت مضبوط دل کا مالک ہیں	Female
/content/drive/MyDrive/dataset/clips/682.wav	 وہ خوشی سے جھوم رہا تھا 	Female
/content/drive/MyDrive/dataset/clips/683.wav	وہ جوش میں لگ رہا تھا 	Female
/content/drive/MyDrive/dataset/clips/684.wav	یہ بہت مزے دار ہے	Female
/content/drive/MyDrive/dataset/clips/685.wav	 میں بہت شوق سے خریدا تھا وہ کتا 	Female
/content/drive/MyDrive/dataset/clips/686.wav	میں تمہارا منتظر رہوں گا 	Female
/content/drive/MyDrive/dataset/clips/687.wav	وہ دلچسپی لے رہی تھی 	Female
/content/drive/MyDrive/dataset/clips/688.wav	میں شکر گزار ہوں 	Female
/content/drive/MyDrive/dataset/clips/689.wav	میں تم سے بہت متاثر ہوں	Female
/content/drive/MyDrive/dataset/clips/690.wav	 وہ بہت حساس تھا	Female
/content/drive/MyDrive/dataset/clips/691.wav	 امبر کی شادی ہو رہی ہے 	Female
/content/drive/MyDrive/dataset/clips/692.wav	کل ہم سوات جا رہے ہیں 	Female
/content/drive/MyDrive/dataset/clips/693.wav	ساتھ والے گھر میں آج بریانی بنی ہے	Female
/content/drive/MyDrive/dataset/clips/694.wav	 میں نے بہت شوق سے خریدا تھا وہ کتا 	Female
/content/drive/MyDrive/dataset/clips/695.wav	کل نیا سال شروع ہو جائے گا 	Female
/content/drive/MyDrive/dataset/clips/696.wav	ہم پارک جا کر اس کا برتھ ڈے سیلیبریٹ کریں گے 	Female
/content/drive/MyDrive/dataset/clips/697.wav	یہ سننے کے بعد میں بہت خوش ہوں کہ تمہیں پتا بھی نہیں سکتی ہو	Female
/content/drive/MyDrive/dataset/clips/698.wav	 اس نے واقعی بولا ہے کہ وہ پانچ سو میں سوٹ دے دے گا 	Female
/content/drive/MyDrive/dataset/clips/699.wav	چلو مہمان کو کچھ پیش کرتے ہیں 	Female
/content/drive/MyDrive/dataset/clips/700.wav	کھانا پیش کیا جا رہا ہے تم سب بھی آ کے کھانا کھا لو   	Female
	 	

	  	
	                     	


	    	





































































































































































































































































